#########
#########
##RRRR###
##R##R###
##R##R###
##RRRR###
#########
